NO ./textures/dungeon/north.png
SO ./textures/dungeon/south.png
WE ./textures/dungeon/west.png
EA ./textures/dungeon/east.png

F 255,219,187
C 144,213,255

1111111111111111111111111111111111111111111
1000000000000000000000000000000000000000001
1000000000000000000000000000000000000000001
100000000000000000000000000000000N000000001
1000000000000000000000000000000000000000001
1000000000111111111111111111000000000000001
10000000001                1000000000000001
10000000001                1000000000000001
10000000001                1000000000000001
10000000001                1000000000000001
10000000001                1000000000000001
1000000000111111111111111111000000000000001
1000000000000000000000000000000000000000001
1000000000000000000000000000000000000000001
1000000000000000000000000000000000000000001
1000000000000000000000000000000000000000001
1111111111111111111111111111111111111111111