NO ./textures/test/north.png
SO ./textures/test/south.png
WE ./textures/test/west.png
EA ./textures/test/east.png

F 135,206,250
C 0, 0, 55

11111111111111111111111111111111111111
100000000000000000000000000000000000S1            
11111111111111111111111111111111111111