NO ./textures/test/north.png
SO ./textures/test/south.png
WE ./textures/test/west.png
EA ./textures/test/east.png
F 220,100,0
C 225,30,0

1111
1 N1
1 11