NO ./textures/dungeon/north.png
SO ./textures/dungeon/south.png
WE ./textures/dungeon/west.png
EA ./textures/dungeon/east.png

F 5,8,12
C 20,30,34

        1111111111111111111111111
        1000000000110000000000001
        1011000001110000000000001
        1001000000D00000000000001
111111111011000001110000000000001
10000000001100000111D1111D1111111
11110111111111011100000010001
1111D111111111111101010010001
11000000110101011100000010001
10000000000000001100000010001
10000000000000001101010010001
11000001110101011111011110N0111
11110111 1110101 101111010001
11111111 1111111 111111111111